11 11
30.0 30.0
# #########
# # # # # #
# # # # # #
#       # #
# ##### # #
#   #     #
####### ###
#   #   # #
# ### # # #
#     #   #
######### #