21 21
30.0 30.0
# ###################
# #       # #   #   #
# # ### ### # # ### #
# # # #       # #   #
# # # # ### ##### # #
# #   # #   #   # # #
# # ##### ### ### ###
#       #     #   # #
# ########### # # # #
#   # # #   #   #   #
# # # # # ### ##### #
# #     #   # # #   #
# ######### # # ### #
#   # #       #   # #
# ### ### # ### ### #
#   #   # #   # #   #
### ### # # ### # # #
#   # # # # #   # # #
# ### # # # # # ### #
#     #   # # #     #
################### #